1111111111111111111111111
1000000000001P000000C0001
1000000000000000101111111
1000000000000000101111111
1000000000000000101111111
1000000000000000101111111
1000000000000000101111111
1000000000000000101111111
1000000000000000101111111
1000000000000000101111111
1000000000000000101111111
1000000000000000101111111
10000000000010E0100000C01
1111111111111111111111111