11111111111111111
1PCE1111111111111
11111111111111111
10000010000110001
10000010000000001
10000000000000000
11111111111111111
