1111111111111111
10C0001001100C01
100P001000C00E11
1C0100C010000C01
1111111111111111
