111111111111111111
100000100001100E01
100P00100000C00001
10000000C000000001
111111111111111111
