11111111111111111
10000010E10110001
1P00001110000C001
10000000C00000001
11111111111111111
