11111111111111111
10000010C10110001
100C000010E00C001
10000100C000000P1
10000000000000001
11111111111111111
