111111111111111111111
10000010C101100000C01
100C000110E00C0000001
10000100C0000000000P1
100C00000001010C00001
111111111111111111111
