11111111111111111
10000011C10110001
1P00001010E00C001
10000000C00000001
11111111111111111
