111111111111111111
10000010E001100011
1P00001000000C0011
10000000C000000011
111111111111111111
